Ibrahim	Taveriner
Lilian	Littrik
Innis	Dorbin
Marsh	MacCallister
Kandace	Giordano
Abigale	Summerson
Davidson	Grocutt
Chan	Cornwell
Donica	Lerego
Ara	Godbald
Beatrisa	Underhill
Cary	Cowgill
Jeannie	Allenson
Sven	Kennerknecht
Abel	Watson
Karla	Gringley
Agneta	Dodwell
Lezlie	Fittall
Jeremiah	Tidd
Georgeanne	Jobern
Bil	Gopsill
Bernarr	Eckert
Ruddie	Aspinell
Madelle	Hocking
Lucias	Peal
Belva	Ivins
Barney	Sirett
Adrea	MacDonnell
Finn	Simkins
Cirlos	jcirlost
Nani	Gino
Michel	Minghi
Nara	Stuchberry
Lynea	Tynan
Quentin	Tansill
Pippy	Sepey
Steward	Broome
Pierrette	De Moreno
Teresita	Raddish
Myer	Clucas
Trudy	Alecock
Emlyn	Olenichev
Randy	Phippard
Jinny	Leatherland
Louisette	Morrissey
Nalani	Henbury
Nicolina	Sabathe
Damon	Brok
Josias	Lynn
Hashim	Swarbrigg
Liv	Maxwale
Florida	Gurnett
Alysa	Higginbottam
Alberik	Demongeot
Kiri	Tayt
Kitty	Book
Debra	Matussov
Budd	Doohey
Herold	Exter
Myriam	Deek
Yardley	Arnson
Fabe	Fulger
Pooh	Allcott
Zonnya	Knottley
Munmro	MacKilroe
Jonell	Murdy
Halli	Itzhaiek
Sargent	Redington
Mitchell	Maud
Paxon	Petroulis
Grantham	Juris
Patton	Sloegrave
Norbert	Adriano
Dionne	Bozier
Mariejeanne	Breyt
Austen	Hunnable
Cedric	Maingot
Andres	Comino
Edgardo	Radenhurst
Garey	McKeady
Quintin	Ryley
Margeaux	Valencia
Elly	Harroll
Sterne	Hindenberger
Janeczka	Dreschler
Olvan	Philippet
Devy	Kidman
Tessi	Troutbeck
Sib	Welchman
Nadeen	Rosen
Ron	Clyde
Beniamino	Cornwell
Esmaria	Everist
Arlyne	Totman
Alistair	Waterhous
Kerry	Vaggers
Fair	Mowsdill
Betsy	Shirt
Helyn	McLaggan
Martguerita	Rayhill
Sheerin	aosheerin2s
Jelene	Kybert
Adora	Fernanando
Lin	Ivachyov
Deirdre	Halwill
Vassily	McDool
Corina	Harefoot
Prue	Shard
Stephanie	Gantlett
Rochell	Bosworth
Clay	Seaborne
Sharron	Stollsteiner
Eliza	Luberti
Cati	Armin
Giuditta	Kruschev
Joshua	Hardiman
Korry	Utridge
Cherrita	Gricks
Neely	Millin
Doe	Pattillo
Mozes	Offa
Moria	Juliano
Marmaduke	Farnan
Gwenette	Escalera
Ellery	Myers
Wandie	Timlett
Cathe	Bowland
Mizen	amizen3j
Roseanna	Ginley
Deina	Mandy
Kiah	Holehouse
Ruth	Caudle
Brianna	Winskill
Kerrin	Whistan
Vikki	Kellert
Deck	Botright
Carlie	Godthaab
Nonna	Paddison
Dulcinea	Glowacz
Georgiana	Glanton
Jonathon	Aronow
Starlene	Pethybridge
Adella	Jobling
Bear	Potes
Alberik	Dutt
Ewan	Braunle
Chilton	Bere
Yank	Doog
Mellicent	Bampkin
Leon	McClaughlin
Marina	Gibke
Bee	Tappor
Giffie	Kubyszek
Shayne	Kellog
Tiphanie	Hullin
Connie	Molloy
Zacharias	Coalbran
Nevins	Battany
Franky	Mounfield
Taryn	Berriman
Nial	Pilpovic
Brook	Skudder
Madelle	Barfford
Jandy	Willoughley
Gardiner	Curuclis
Shandee	Devennie
Auguste	Ardy
Angelique	Wackly
Jone	Tsarovic
Vito	Mandrier
Zora	Sotworth
Alecia	Ruffell
Umeko	Bonn
Papageno	Capponeer
Lesli	Relfe
Valentijn	Inkin
Trey	Beatey
Roxanne	Dradey
Laryssa	Duckit
Forest	Outerbridge
Arabel	Kleinsmuntz
Sutherland	Jenicke
Jany	Hallyburton
Pegeen	Huck
Yancy	MacClay
Janetta	Mansford
Rosemary	Tildesley
Robert	Jedraszek
Eustacia	Eliaz
Brollachain	cobrollachain59
Lexi	Robken
Ophelie	Laimable
Radcliffe	Eltone
Anselm	Boustred
Laetitia	Leadston
Carmel	Damsell
Gilbert	Gartenfeld
Tome	Sunman
Koenraad	Riach
Katey	Syce
Hamnet	Panner
Adda	adadda5l
Evelyn	Otridge
Molly	Minero
Anthiathia	Scroyton
Maximilian	Bales
Sammie	Satford
Lynnea	Dudliston
Crysta	Tinto
Debbie	Petruska
Gabbi	Bosket
Trudie	Donaghy
Bunnie	Colaton
Teresita	Shavel
Margery	Binner
Eldredge	Kenton
Perren	Kitching
Raddy	Allewell
Julie	Korneichuk
Reinaldo	Cody
Augusto	Aronowitz
Maddy	Rotge
Celestyn	Martyntsev
Derk	Littlefair
Raimund	Filpo
Frankie	Fletcher
Viki	Falkingham
Davy	Farryn
Jeramey	Farrent
Sumner	Allport
Estella	Estrella
Guss	Butterfill
Hillery	Hazelden
Bobbe	Mattheus
Lawry	Yarwood
Berky	Dyshart
Phillie	Lancley
Travis	Mallows
Glenn	Treasure
Mag	Sandbach
Farrell	cofarrell6o
Rowney	Crat
Rebe	Mityashin
Brent	Peppett
Cecile	Blay
Modestia	Allwell
Corliss	Blackeby
Bordy	Casely
Lurette	Konerding
Darius	Suttle
Weidar	Barneveld
Maudie	Eagles
Hakim	Skeldon
Madalena	Stubley
Becki	Sprules
Nicol	Aujouanet
Broderic	Darracott
Sibel	Newport
Berkly	Getley
Boy	Erett
Elizabeth	Isenor
Laurie	Hanbury
Brown	lhanburybrown79
Rhodie	Jeffray
Jacquelynn	Slimm
Donnie	Rollinson
Honoria	Guare
Alyosha	Pull
Marietta	Bourgeois
Thalia	Pollastrone
Dorelle	Gierhard
Adrian	Jochen
Jannelle	Arndell
Peter	Boram
Amalee	Singyard
Abbe	Searchwell
Adelice	Schimaschke
Lark	Wagstaffe
Roi	Gambie
Grada	lograda7q
Jessi	Gadsdon
Desiree	Littrick
Averell	Kemmis
Barret	Lavis
Barbette	Scard
Ellynn	Hedon
Cordy	Gillman
Emmalynn	Lavrick
Pris	Philp
Holden	Kilbane
Hillyer	Crummey
Freddie	Delahunty
Teodor	Sapseed
Etta	Bussell
Alejandro	Brazelton
Dorian	Daouse
Chen	Stebbings
Tom	Maving
Gerick	Thon
Dornan	codornan8a
Mirabella	Farthin
Domenico	Wildbore
Andrey	Glackin
Abbey	Hischke
Tish	McKie
Jule	Hove
Sympson	hsympson8h
Jayme	Fallanche
Duke	Jenney
Vanni	Febre
Siana	Swetman
Alexa	Cossons
Jo	Balk
Anthony	Buffey
Lilas	Draijer
Sly	Zoppo
Jorie	Ferreras
Selinda	Ballister
Hunt	Ottiwill
Toby	Guerrier
Scott	Schechter
Fayth	Bront
Josefina	Minchi
Valentino	Dodshon
Nadean	Baggett
Kris	Barock
Roseann	Iskov
Tina	Klimkowski
Min	Gallihawk
Al	Bray
Lyn	Boseley
Hetty	Fries
Kitty	Dugan
Jannel	Chalk
Zacharias	Davy
Archibald	Ciciura
Aguistin	Devlin
Anatola	Rusbridge
Christyna	Remer
Ingar	Duchant
Zorina	Conigsby
Israel	Diben
Rhianon	Vinden
Marilin	Santacrole
Andie	Mockford
Merline	Gildersleeve
Chris	Shrimpling
Farlay	Trusler
Roddie	Lumsdall
Lanette	Minette
Chilton	Castell
Maribelle	Minchindon
Ezekiel	Ramsbotham
Jabez	Brindle
Gerda	Bauldry
Rafe	Pele
Viv	Dispencer
Abram	Bachman
Mella	Nudde
Ced	Ricker
Whitaker	Yorkston
Chryste	Tull
Hatti	Dargie
Tonye	Cowill
Merissa	Kimbling
Denis	Barfford
Jacki	Hinge
Dy	mdya6
Adam	Klimschak
Neala	Shackle
Iseabal	Babst
Siana	Panks
Dwain	Skelly
Milton	Bayless
Lucien	Westcot
Nicolette	Klus
Renell	Owtram
Arvin	McKune
Tobias	Thickin
Modestia	Jaggli
Fionna	Sandiland
Wesley	Battyll
Kinsley	Lambertazzi
Ivan	Dorn
Mari	Moth
Rori	Ellaman
Gisele	Defraine
Jolynn	Zemler
Cello	Prigmore
Rahal	Pontefract
Walworche	dwalworcheat
Hymie	Dainty
Michal	Rafferty
Jolie	Lurcock
Aurea	Davioud
Adolphus	Oland
Nyssa	McConway
Kalila	MacKeller
Shepperd	Fall
Skyler	Warbeys
Sharai	MacGillavery
Morry	Kupec
Lehane	colehaneb5
Sharla	Scintsbury
Edyth	Spurett
Artie	Janecki
Verene	Baudi
Elladine	Baistow
Fanny	Roglieri
Vasily	Hilary
Raymond	Stobbe
Julieta	Ambroix
Nicola	Getley
Gallagher	Sutworth
Beltran	Harby
Candace	Loughney
Heinrik	Coppock
Selle	Goudge
Krishna	Woodworth
Milt	Jeratt
Hilda	Wharton
Salli	Ortmann
Ferris	Edwicke
Mendie	Croisier
Jessie	Bools
Corena	Garnsey
Reina	Majury
Ricki	Bilovus
Shirline	Satchel
Waylan	Nabarro
Josiah	Wisedale
Elwood	Bazely
Oneida	Trevan
Olivette	Cattemull
Mendy	Chainey
Christa	McKim
Abra	Colbert
Carlos	Worwood
Roman	Nealy
Tobye	Learie
Horst	McGillivray
Leona	Birtonshaw
Olivier	Streater
Bethena	Baxstair
Mercie	Pratte
Urbano	Jedrachowicz
Jordon	Daniell
Aube	Figliovanni
Brodie	Bradnam
Brigid	Bonin
Roddie	Radband
Birgit	Comsty
Cordy	Killerby
Melva	Blakemore
Judah	Benes
Celia	Simmans
Blakeley	Lakenden
Cosimo	Norrington
Charlton	Walworth
Delinda	Spiers
Maynord	Bode
Beatrice	Holdron
Roscoe	Spray
Serge	Corre
Lea	Sellek
Maressa	Pellew
Blancha	Greves
Brianna	Pirrie
Hodge	Hindsberg
Libbey	Rickeard
Gabriele	Sturge
Kira	Clemont
Padraic	Metzing
Episcopi	dlepiscopid4
Kirby	Reece
Patty	Taunton
Good	vlegoodd7
Janot	Tankin
Penny	Lohrensen
Granger	Jeffcock
Edna	Sorbey
Taylor	Hampshaw
Stanley	Harner
Stephani	Walmsley
Noby	Drissell
Clarey	Dayne
Tab	Woollcott
Gib	Syncke
Cherilyn	Coundley
Colin	Sturridge
Delores	Olivelli
Arty	Bechley
Humphrey	Deevey
Erl	Sandcraft
Gael	Hearson
Dukey	Cocking
Randi	Bowness
Harlin	Lantaff
Sisile	Jermyn
Patrice	Priscott
Stavro	Rapley
Broderic	Petrushka
Teriann	Heeney
Thorstein	Gettone
Elsey	Potzold
Augustina	Batter
Lynelle	Bradman
Llewellyn	Pococke
Ricard	McCloughen
Sholom	Ballantyne
Flint	Topham
Lindsy	Moran
Currigan	kocurrigane7
Steffane	Grenshiels
Josi	Radsdale
Kelley	Falcus
Hollie	Catford
Jacquenetta	Budden
Farly	Taverner
Gabriella	Alessandrini
Jyoti	Abotson
Harriet	Blomfield
Jacquelin	Toffanini
Scotty	Tainton
Mason	Yokelman
Aeriel	Tesdale
Mara	bomarael
Irvin	Pischel
Gilberta	Dishmon
Caril	Dewer
Mallissa	Overland
Gretchen	Ingray
Brigit	Reeve
Jorry	Swatman
Molly	Saltrese
Lenette	McGrill
Barron	Mantripp
Karlie	Pyner
Wilbur	Sambell
Rosalie	Chstney
Carie	Poacher
Timothy	Nelhams
Merl	Reed
Tannie	Albone
Barnabas	Ackland
Ferd	Chree
Wit	Taverner
Mariam	Andrieu
Vincents	Stadding
Phaidra	Kupka
Ailis	Rowlstone
Ted	Ewer
Christophe	Casaletto
Tod	Exrol
Arlyn	Barthrop
Fowler	Bremner
Kasey	Fessler
Rosy	Statton
Francine	Merritt
Holden	Henworth
Merrilee	Bulle
Bethena	Doucette
Nealy	Escolme
Keefer	Markovich
Jeanine	Cianelli
Corny	Graith
Eddie	Fortun
Hilde	Disley
Sofia	Chesney
Quintus	Spikeings
Opalina	Dallender
Malena	Tabord
Melloney	Dumberell
Sibley	Piggford
Richmond	Halksworth
Hyacinthie	Staines
Leland	Kalberer
Brana	Prin
Gawen	Langcastle
Judas	Dannel
Arlyne	Cotte
Anabel	Eich
Jaymee	Jarrett
Karlan	Templar
Elka	Monument
Thibaud	Carmo
Silva	Brame
Layton	Vandenhoff
Sigismundo	Alfwy
Annis	Rivers
Shel	Haddow
Yasmeen	Edowes
Maddie	Rout
Larina	Ranaghan
Betsey	Petrovykh
Ezechiel	Challiss
Emilie	Gildroy
Maximilien	Cossam
Neala	Ashtonhurst
Akim	Armin
Rory	Peace
Bruno	Northen
Brooks	Green
Ebony	Santori
Ericha	Linnell
Ariella	Cundy
Storm	Wrathmell
Aylmar	Baraclough
Shanan	Capron
Laurens	Strickler
Raynard	Whotton
Daniel	MacLardie
Dorolisa	Shobbrook
Crosby	Pask
Barrett	Leidl
Bernardine	Habin
Florida	Jendas
Alethea	Isakov
Guillaume	Handyside
Janenna	Clemmensen
Tori	MacLure
Marietta	Cottom
Jaimie	Sanzio
Lloyd	Renshall
Julie	Littleover
Nettle	Powell
Vidovik	Vase
Monty	Gilloran
Sanders	Dorrins
Cayla	Chooter
Clemmie	Franz
Freemon	Beckenham
Roderich	Spiers
Wilma	Kerin
Madelaine	Auger
Natty	Covendon
Wilhelm	Espinet
Garv	Cleminson
Onfre	Endrighi
Sheri	Dilke
Moina	McIlrath
Noel	Manneville
Kim	Adnams
Robb	Corss
Sephira	Loiterton
Ginnie	Gason
Joella	Zemler
Claire	Atwood
Renie	Labb
Cale	Whissell
Austin	Skyrme
Branden	McEnteggart
Shantee	La Grange
Jeannie	Corneljes
Liza	Jurisch
Corey	Markwick
Andrew	de Mendoza
Vivian	Brixham
Kare	Vlasenkov
Huntley	Pessold
Callean	Antonellini
Deedee	Heimes
Jeanette	Crisall
Ruth	Smedmore
Travers	Goring
Oswell	Tichelaar
Dee	Besset
Cynthia	Huitt
Karyl	Bettam
Web	Ronald
Cherie	Mateos
Viv	Leban
Jean	Clementucci
Eimile	Hancke
Sammy	Smead
Patrice	Brisard
Lowell	Petrashkov
Gregorius	Adamovitch
Aurthur	Petchey
Glynn	Robyns
Marguerite	Stears
Delora	Glenny
Brade	Canniffe
Fancie	Parnham
Hillie	Bettington
Johanna	Lampl
Darla	McCue
Sarge	Borgars
Theresita	Radbourn
Clemente	Krause
Janos	Bulloch
Mark	Franciotti
Laurie	Choudhury
Audrie	Wicken
Carolann	Cough
Valaria	McHarry
Dorine	Wilcocks
Minnaminnie	Leipelt
Dene	Hugonet
Brice	Mattevi
Osborne	Durban
Elwyn	Stigers
Burt	Duetsche
Radcliffe	Kinchley
Ogdon	Paolini
Woody	Baroux
Mohandis	Dornan
Aguistin	Cackett
Shirl	Russell
Lazaro	Livingstone
Debor	Barnhart
Rene	Bushell
Denise	Edgars
Minnaminnie	de Villier
Ellwood	Tayler
Iormina	Dericot
Spenser	Uff
Lulita	Hallbord
Svend	Undrill
Dolley	McNellis
Cortie	Haburne
Tildie	Ffrench
Aleece	Lansdale
Gretal	Levinge
Nancee	Candy
Benyamin	Lamort
Erastus	Phebee
Issy	Peskin
Elladine	Guichard
Lida	Sotham
Brogan	gobrogank9
Viva	Bernaldez
Odie	Shoubridge
Ursala	Cocks
Bentley	Ginsie
Zilvia	Attwool
Phillipp	Barbrick
Kristyn	Melville
Noreen	Leyman
Mikael	Samwayes
Betsey	Meininking
Shellysheldon	Catchpole
Brana	Davenport
Renault	Krolik
Adan	Brimmicombe
Sibby	MacArthur
Nicolais	Attle
Bowie	Gorbell
Asia	Domange
Vite	Bauld
Winfred	Childerley
Marilee	Dollard
Anabelle	Schimoni
Holli	Elcott
Maximilian	Camilio
Bucky	Tinn
Gregor	Varney
Karola	Lintin
Galvin	Filipson
Carmody	docarmodyl2
Ricardo	Waycot
Levon	Agron
Hamel	Riteley
Blondelle	Jonke
Rice	Enrique
Heidi	Rutherfoord
Haskell	Ternott
Patton	Dudderidge
Quintana	Reddin
Mariellen	Milkins
Hailee	Aylesbury
Marigold	Linforth
Garfield	Dalyell
Ernst	Braben
Skippie	Chidzoy
Katina	Yateman
Thorin	Curness
Lewes	Blanko
Paige	Corben
Ingmar	Edmans
Cordy	Pandya
Hilary	Stoving
Dina	Dowell
Zebulen	Baignard
Hanan	Rumble
Gretel	Whyler
Pierce	Miche
Brantley	Sawden
Burtie	Fakes
Ed	Cosbey
Rockwell	Russel
Emilio	Carey
Deane	Wort
Anallise	Landers
Les	Rothery
Angelle	Mocquer
Germayne	Evamy
Portie	Wildman
Antons	Laroux
Clarey	Snoday
Juli	Climance
Melessa	Loudiane
Kristi	Freiberg
Daveta	Winstone
Gerladina	Thickins
Devlin	Lambrecht
Bridget	Karlsen
Amata	Camin
Julie	Zanazzi
Ellette	Gogin
Gabbie	Kaesmakers
Gretchen	Fishlock
Brock	Dyte
Wilton	Buckleigh
Shanan	Hagard
Raquel	Crittal
Thomasine	Curzon
Jody	Pavie
Connie	Pitherick
Nico	St Angel
Desmund	Cutcliffe
Polly	Coysh
Price	Rosnau
Mela	Embery
Sibelle	Malthus
Greer	Fearey
Meris	Armour
Reece	Kensley
Bessy	Titcomb
Corliss	Ledur
Hugibert	Figin
Erwin	Bearfoot
Danila	De Ferrari
Edouard	Trewartha
Alexio	Kingsnod
Kenton	Bevan
Cordy	Fishby
Gerhardt	Soltan
Loria	Tumioto
Jarrod	Archley
Randal	Baytrop
Thane	Mussetti
Alessandro	Charlson
Tory	Puller
Gertruda	Bullin
Claudianus	McVicar
Joaquin	Whitehall
Mikkel	Bowyer
Pepillo	Burburough
Verine	Cornwell
Jard	Runcieman
Herta	Oakland
Alexio	Vina
Killy	Altofts
Nadya	Adolfsen
Jammie	Wrightham
Hortense	Deegin
Baird	Kincey
Arleta	Jeannaud
Cole	Penk
Nehemiah	Birbeck
Rodger	Brahms
Haskell	Lewson
Munmro	Pimlock
Adelaida	Fenix
Pietra	Jeremiah
Almeria	Manger
Rudden	roruddeno2
Jake	Hanscombe
Fair	Stuffins
Jilleen	Andrassy
Kriste	Balshaw
Tiffie	Brimmacombe
Aluin	Gyde
Dayle	Wigglesworth
Sisely	Slateford
Bernice	Clarkson
Hieronymus	Carluccio
Zechariah	Frandsen
Iseabal	Easby
Hinze	Natte
Tressa	Rosenstock
Nomi	Berk
Taite	Egarr
Lionello	Deboo
Noach	Starsmore
Nalani	Pawelek
Garnette	Hullett
Clair	Dalligan
Amandy	Few
Padget	Sandry
Rose	Hyde
Elroy	Pomfrett
Andres	Kaas
Derby	Ambrogioli
Elaina	Duffer
Maighdiln	Tenbrug
Vinny	Sawley
Blair	Ortner
Dredi	Nuccii
Shevlin	toshevlinoz
Corene	Crippes
Edyth	Bellward
Jillian	Pollett
Alethea	Lambertz
Dorry	Alessandrucci
Victor	Rubury
Keely	Le Surf
Glennis	Probetts
Nerta	Ballintyne
Freeland	Spier
Honor	Grimston
Sunshine	Kearford
Oralla	Siggery
Melisandra	Airey
Kaiser	Ludlem
Ludovico	Dicker
Hyacinth	de Najera
Laryssa	Eamer
Theresina	Streatfield
Knivett	cknivettpj
Wait	Yakolev
Ilsa	Samarth
Calla	Knyvett
Vitoria	Loder
Hilario	Alf
Colman	Alvey
Selig	Cerman
Tailor	MacNalley
Harwilll	Chance
Rhody	Nursey
Kellia	Stubbert
Isadore	Sunner
Damaris	Karczinski
Clari	Brosi
Estrella	Cressar
Kristin	Leftwich
Julio	Blowes
Euphemia	Burgane
Brad	MacGown
Ninon	Gerrill
Kelsy	Pentlow
Ryley	Igonet
Myrtia	Killock
Farrel	Bernli
Isaak	Chappelow
Lemuel	Musicka
Carey	Hugo
Cad	Lilian
Bryce	Abrahmovici
Gil	Flaxon
Amalita	Beggan
Walther	Bissett
Lilly	McIver
Shae	Fick
Janel	Popplestone
Dorian	Sidary
Nehemiah	Tomasz
Hamlin	Peret
Roby	Lindstrom
Karlis	Denizet
Matteo	Le Bosse
Hobart	Cook
Tessie	Allridge
Edwina	MacCombe
Ulrick	Tookill
Towny	Mandeville
Melony	Perotti
Granger	McKoy
Raye	Sorsbie
Adams	Jerrim
Orelle	Davidovicz
Arvie	McQuode
Klara	Farden
Edee	Rock
Griffy	Kensington
Westleigh	Crudginton
Margo	Lebreton
Say	Mustoo
Kingston	Proske
Glyn	Trorey
Kent	Mallia
Krystal	Meiklam
Jasper	Jouning
Herc	Ousley
Thomasina	Guys
Laina	Macrow
Lesya	Dobbie
Cesya	Ellwand
Turner	Ranken
Marchelle	Engledow
Oralia	Peggram
Bianca	Karlowicz
Tressa	Ivanov
Abbey	Avey
Georgianna	Prestie
Gretchen	Partington
Maribelle	Waeland
Bentley	Cromett
Loughran	doloughranrq
Horace	Woods
